1111111111111111111111111111111111
1E0000000000000C00000C000000010001
1010010100100000101001000000000101
1010010010101010001001000000000101
100000000C00C0000000000000000100C1
100000000000000C00000C000000010001
1010010100111111101001000000010101
1010010011101010001001000000000101
100001000C10C000000000000000P100C1
1111111111111111111111111111111111
